Table de Correspondance : Ancien -> Nouveau
===========================================
advBarroud -> po.adv.barroud
sneak -> po.stat.sneak
aimant -> po.use.magnet 
cthunEye -> po.misc.cthuneye
slime -> po.misc.slime
timer -> po.tech.global_timer
timeRac -> po.cd.racine
achatAss -> po.shop.assassin
cible -> po.misc.cible
intangibilite -> po.use.intangible
mirroir -> po.use.mirror
timeProtect -> po.cd.protect
mort -> po.stat.deaths_match
trident -> po.use.trident
sonEnder0 -> po.sound.enderpearl0
menu -> po.ui.kit_menu
randomXal -> po.legacy.randomxal
lifeTourelle -> po.tech.life_turret
vie -> po.tech.remaining_lives
PlayerTimer -> po.timer.playertimer
nbconnection -> po.stat.joins
sonEnder1 -> po.sound.enderpearl1
medaillon -> po.misc.medaillon
menumap -> po.ui.map_menu
timeIntan -> po.cd.intangible
vicDruide -> po.win.druide
cosForestier -> po.cos.forestier
cristalVie -> po.use.life_crystal
charge -> po.use.charge
kit -> po.state.kit_id
familier -> po.use.familiar
fishing -> po.use.rod
balise -> po.tech.balise
couche -> po.tech.layer
controle -> po.use.control
nether -> po.shovel.netherite
pelle1 -> po.model.pelle1
map2b -> po.map.res2
druide -> po.kit.druide
assassinat -> po.use.assassinate
position -> po.tech.pos_hp
mareenoire -> po.use.black_tide
rocket -> po.legacy.rocket
map2 -> po.map.v2
constru -> po.use.build_wand
fant -> po.shop.fantome
equipLassoSon -> po.cos.sound.equiplasso
fumi -> po.use.smoke
chevalier -> po.kit.chevalier
murloc -> po.kit.murloc
glasDivin -> po.use.bell
pelle4 -> po.model.pelle4
nbPlan1 -> po.ctf.flag1
map3b -> po.map.res3
pierre -> po.shovel.stone
Cfleche -> po.legacy.cfleche
crossbow -> po.use.crossbow
DetectMort -> po.legacy.detectmort
play -> play
timeRaz -> po.cd.raz
equipEnder -> po.cos.equipender
chasseurGG -> po.kit.chasseurgg
levi -> po.use.levitation
testfish -> po.misc.testfish
victoires -> po.win.total
timeWater -> po.tech.water_timer
batisseur -> po.kit.batisseur
xalDetect -> po.legacy.xaldetect
lienSang -> po.use.bloodlink
timeEffect -> po.timer.effect
map1 -> po.map.v1
coins -> po.coins
armeeNaga -> po.use.naga_army
bouclierRep -> po.use.shield_rep
timeTotem -> po.cd.totem
fantome -> po.use.phantom
deluge -> po.use.deluge
puissance -> po.use.power
invul -> po.tech.invulnerable
contrat -> po.use.contract
achatCGG -> po.shop.chasseur_gg
modenderP2 -> po.model.enderpearl2
nbPlan5 -> po.ctf.flag5
pelle0 -> po.model.pelle0
timeBlock -> po.timer.block
food -> po.tech.food
timeCharge -> po.cd.charge
achatBat -> po.shop.batisseur
bouclier -> po.use.shield_cookie
partieJoue -> po.stat.games_played
lifeF -> po.tech.life_f
ailesDange -> po.use.wings
cosmeticmenu -> po.ui.cosmetic_menu
vicMage -> po.win.mage
RageS -> po.use.rage
Pos -> po.tech.pos
vicChaman -> po.win.chaman
clock -> po.use.clock
toxi -> po.use.toxic
kitSelect -> po.state.kit_selecting
modulo -> po.tech.modulo
TimeM3 -> po.cd.m3
creeper -> po.legacy.creeper
OTV -> po.misc.otv
randkit -> po.legacy.randkit
achatInge -> po.shop.ingenieur
vicChevalier -> po.win.chevalier
timeLien -> po.cd.lien
modLasso0 -> po.model.lasso0
modLasso1 -> po.model.lasso1
flint -> po.use.flint
brick+ -> po.misc.brick+
advDudanger -> po.adv.dudanger
MaitreM -> po.kit.maitrem
TimeM4 -> po.cd.m4
TimeM2 -> po.cd.m2
arti -> po.use.crossbow_arti
TimeM1 -> po.cd.m1
TimeTourelle -> po.cd.tourelle
vicMaitreM -> po.win.maitrem
setGame -> po.tech.game_set
huile -> po.use.huile
timeMirror -> po.cd.mirror
victoire -> po.win.detectwin
lienGOD -> po.use.liengod
achatMur -> po.shop.murloc
connection -> po.stat.play_time
storeGrav -> po.legacy.storegrav
timePuissance -> po.cd.puissance
gel -> po.use.freeze
vicBatisseur -> po.win.batisseur
ingenieur -> po.kit.ingenieur
ranger -> po.kit.ranger
raltime -> po.use.slow_time
algue -> po.shop.druide
sauvetage -> po.tech.save
nbPlan4 -> po.ctf.flag4
vicCGG -> po.win.cgg
modenderP3 -> po.model.enderpearl3
cosRanger -> po.cos.ranger
randGlas -> po.legacy.randglas
realiteGOD -> po.use.god_reality
pieces -> po.stat.gold_picked
underwater -> po.misc.underwater
watersource -> po.legacy.watersource
racine -> po.use.racine
guerrier -> po.kit.guerrier
Vision -> po.use.vision
vicAssassin -> po.win.assassin
vicIngenieur -> po.win.ingenieur
raz -> po.use.raz
pelle5 -> po.model.pelle5
nbPlan2 -> po.ctf.flag2
timePeau -> po.cd.peau
peau -> po.use.peau
fer -> po.shovel.iron
modenderP1 -> po.model.enderpearl1
achatMM -> po.shop.maitre_m
mage -> po.kit.mage
timeCible -> po.cd.cible
nbPlan6 -> po.ctf.flag6
deco -> po.stat.leaves
enderpearlPartie -> po.use.pearl_game
cheval -> po.shop.chevalier
fantomeK -> po.kit.fantome
vicRanger -> po.win.ranger
titre -> po.timer.titre
grav -> po.misc.grav
lancer -> po.use.ender_pearl
timeObjA -> po.cd.obj_angelique
diamant -> po.shovel.diamond
pelle3 -> po.model.pelle3
comptarba -> po.cd.arbalete
sonLasso0 -> po.sound.lasso0
sonLasso1 -> po.sound.lasso1
map4b -> po.map.res4
map -> po.map.vote_id
map4 -> po.map.v4
skull -> po.shop.necromancien
vieVision -> po.tech.life_vision
resu -> po.misc.resu
or -> po.shovel.gold
PoseTourelle -> po.use.turret_place
enderVoid -> po.tech.void_pearl
map3 -> po.map.v3
assassinK -> po.kit.assassin
timeCont -> po.cd.cont
vicMurloc -> po.win.murloc
vicNecro -> po.win.necro
equipEnderSon -> po.cos.sound.equipender
invocation -> po.misc.invocation
grapRanger -> po.legacy.grapranger
changeKit -> po.state.kit_changing
cosFlecheRetour -> po.cos.previous_menu
encre -> po.shop.chaman
chaman -> po.kit.chaman
inversDestin -> po.use.fate_inverse
equipLasso -> po.cos.equiplasso
enderpearlGlobal -> po.use.pearl_global
horn -> po.use.horn
timeTox -> po.cd.toxic
lancerInstant -> po.misc.lancerinstant
map1b -> po.map.res1
cosRangerG -> po.cos.rangerg
air -> po.use.air
timeVision -> po.cd.vision
plan -> po.timer.plan
piegehuile -> po.legacy.piegehuile
Repulseur -> po.use.repulsor
lifeBullet -> po.tech.life_bullet
necromancien -> po.kit.necromancien
vicFantome -> po.win.fantome
totem -> po.use.totem
vicGuerrier -> po.win.guerrier
aggroNaga -> po.legacy.aggronaga
modenderP0 -> po.model.enderpearl0
TourelleP -> po.use.turret_p
modenderP4 -> po.model.enderpearl4
tp -> po.use.spyglass_tp
eventType -> po.legacy.eventtype
QTB -> po.legacy.qtb
timePerturb -> po.cd.perturb
pelle2 -> po.model.pelle2
Timefant -> po.cd.fantome
nbPlan3 -> po.ctf.flag3
poseBlock -> po.legacy.poseblock
mine -> po.use.mine
forestier -> po.kit.forestier
flotHuile -> po.legacy.flothuile
timeClock -> po.cd.clock
protect -> po.use.protect
multibow -> po.use.bow_multi
secWater -> po.stat.water_time
vicForestier -> po.win.forestier
bois -> po.shovel.wood

====================================
MANQUANT
====================================
vicpartieJoue
hunt
timeHunt